    #####
    #...#
    #o..#
  ###..o##
  #..o.o.#
###.#.##.#   ######
#...#.##.#####..xx#
#.o..o..........xx#
#####.###.#S##..xx#
    #.....#########
    #######
