############
#xx..#.....###
#xx..#.o..o..#
#xx..#o####..#
#xx....S.##..#
#xx..#.#..o.##
######.##o.o.#
  #.o..o.o.o.#
  #....#.....#
  ############
