        ########
        #.....S#
        #.o#o.##
        #.o..o#
        ##o.o.#
#########.o.#.###
#xxxx..##.o..o..#
##xxx....o..o...#
#xxxx..##########
########
