        #####
        #...#####
        #.#o##..#
        #.....o.#
#########.###...#
#xxxx..##.o..o###
#xxxx....o.oo.##
#xxxx..##o..o.S#
#########..o..##
        #.o.o..#
        ###.##.#
          #....#
          ######
