          #######
          #..xxx#
      #####..xxx#
      #......x.x#
      #..##..xxx#
      ##.##..xxx#
     ###.########
     #.ooo.##
 #####..o.o.#####
##...#o.o...#...#
#S.o..o....o..o.#
######.oo.o.#####
     #......#
     ########
