 ###  #############
##S####.......#...#
#.oo...oo..o.o.xxx#
#..ooo#....o..#xxx#
#.o...#.oo.oo.#xxx#
###...#..o....#xxx#
#.....#.o.o.o.#xxx#
#....######.###xxx#
##.#..#..o.o..#xxx#
#..##.#.oo.o.o##xx#
#.xx#.#..o......#x#
#.xx#.#.ooo.ooo.#x#
#####.#.......#.#x#
    #.#########.#x#
    #...........#x#
    ###############
