################
#..............#
#.#.######.....#
#.#..o.o.o.o#..#
#.#...oSo...##.##
#.#..o.o.o###xxx#
#.#...o.o..##xxx#
#.###ooo.o.##xxx#
#.....#.##.##xxx#
#####...##.##xxx#
    #####.....###
        #.....#
        #######
