   #########
  ##...##..#####
###.....#..#....###
#..o.#o.#..#..xxx.#
#.#.o#So##.#.#x#x.#
#..#.#o..#....x.x.#
#.o....o.#.#.#x#x.#
#...##..##o.o.x.x.#
#.o.#...#..#o#x#x.#
##.o..o...o..oxxx.#
 #o.######....##..#
 #..#    ##########
 ####
