   ########
   #...#..#
   #..o...#
 ###.#o...####
 #..o..##o...#
 #..#.S.o.#.o#
 #..#......o.####
 ##.####o##.....#
 #.o#xxxxx#.#...#
 #..oxx@@x.o#.###
##..#xxxxx#...#
#...###.#######
#.oo..#..#
#..#.....#
######...#
     #####
